Cod,Departamento,Edificaciones C. Municipal,Edificaciones C. Poblado,Edificaciones Rural Disperso y Resto,Personas C. Municipal,Personas C. Poblado,Personas Rural Disperso y Resto,Total edificaciones,Total personas,Población urbana,Edificaciones urbanas
5001,5,223527,5199,928,2319057,19983,19520,229654,2358560,2339040,228726
5002,5,2395,135,132,6923,437,10202,2662,17562,7360,2530
5004,5,278,27,74,706,90,1343,379,2139,796,305
5021,5,660,0,46,2201,0,1624,706,3825,2201,660
5030,5,2613,2411,144,12938,8082,5655,5168,26675,21020,5024
5031,5,3541,53,377,11538,212,8026,3971,19776,11750,3594
5034,5,2863,936,150,18095,3426,15349,3949,36870,21521,3799
5036,5,564,340,65,1962,975,2073,969,5010,2937,904
5038,5,735,124,137,2369,393,7731,996,10493,2762,859
5040,5,1708,159,446,7031,596,6822,2313,14449,7627,1867
5042,5,4393,169,212,15261,698,6984,4774,22943,15959,4562
5044,5,352,265,132,1180,802,4400,749,6382,1982,617
5045,5,18332,3159,322,91683,13370,6959,21813,112012,105053,21491
5051,5,2524,796,744,9609,2514,14139,4064,26262,12123,3320
5055,5,762,0,53,2973,0,3752,815,6725,2973,762
5059,5,411,104,50,1359,264,2194,565,3817,1623,515
5079,5,2038,573,219,21465,5506,17636,2830,44607,26971,2611
5086,5,513,96,67,1602,266,3481,676,5349,1868,609
5088,5,55933,2229,439,456677,12296,8449,58601,477422,468973,58162
5091,5,551,14,55,3400,94,5094,620,8588,3494,565
5093,5,1009,336,134,4163,990,9909,1479,15062,5153,1345
5101,5,3000,513,203,14484,1469,7093,3716,23046,15953,3513
5107,5,576,132,139,2444,329,3157,847,5930,2773,708
5113,5,440,146,150,2033,544,4789,736,7366,2577,586
5120,5,1503,3247,925,5244,12097,8760,5675,26101,17341,4750
5125,5,474,0,56,1507,0,5507,530,7014,1507,474
5129,5,7254,2154,230,61426,10044,4479,9638,75949,71470,9408
5134,5,565,162,87,2334,490,4572,814,7396,2824,727
5138,5,872,347,355,4729,968,7825,1574,13522,5697,1219
5142,5,536,0,69,2430,0,1523,605,3953,2430,536
5145,5,755,91,15,1941,279,2044,861,4264,2220,846
5147,5,8349,1810,458,31604,6623,7037,10617,45264,38227,10159
5148,5,6044,384,207,32881,1419,19305,6635,53605,34300,6428
5150,5,1059,0,13,2618,0,700,1072,3318,2618,1059
5154,5,17935,1339,406,74013,5309,4810,19680,84132,79322,19274
5172,5,12034,384,508,46533,1243,6240,12926,54016,47776,12418
5190,5,1461,0,38,7688,0,1203,1499,8891,7688,1461
5197,5,1875,172,113,5916,499,8270,2160,14685,6415,2047
5206,5,722,0,44,1752,0,2148,766,3900,1752,722
5209,5,1709,237,91,6804,688,8566,2037,16058,7492,1946
5212,5,7815,212,145,62011,968,13005,8172,75984,62979,8027
5234,5,2433,180,385,8831,696,9536,2998,19063,9527,2613
5237,5,1727,144,37,11025,268,2865,1908,14158,11293,1871
5240,5,624,267,62,1816,1238,7234,953,10288,3054,891
5250,5,8775,2873,826,29419,9505,8344,12474,47268,38924,11648
5264,5,1004,0,60,5088,0,3688,1064,8776,5088,1004
5266,5,17993,519,154,201845,1731,7947,18666,211523,203576,18512
5282,5,1788,328,108,7681,1106,9947,2224,18734,8787,2116
5284,5,2387,413,216,8010,1426,7269,3016,16705,9436,2800
5306,5,178,28,39,1850,273,2932,245,5055,2123,206
5308,5,2365,926,145,27882,6540,13848,3436,48270,34422,3291
5310,5,1475,208,155,4239,539,3433,1838,8211,4778,1683
5313,5,794,103,49,5229,180,3679,946,9088,5409,897
5315,5,601,79,73,2124,379,2932,753,5435,2503,680
5318,5,2820,263,201,17346,972,23695,3284,42013,18318,3083
5321,5,1231,196,28,5207,452,1333,1455,6992,5659,1427
5347,5,791,325,60,2078,671,1953,1176,4702,2749,1116
5353,5,695,0,21,3303,0,1647,716,4950,3303,695
5360,5,27322,3036,57,234847,22498,4130,30415,261475,257345,30358
5361,5,1852,756,347,6502,1945,9951,2955,18398,8447,2608
5364,5,1987,85,200,7064,346,6025,2272,13435,7410,2072
5368,5,1799,54,55,6814,247,3984,1908,11045,7061,1853
5376,5,10340,338,227,51345,1179,6248,10905,58772,52524,10678
5380,5,8259,768,142,57441,3289,6251,9169,66981,60730,9027
5390,5,1634,74,33,7046,421,497,1741,7964,7467,1708
5400,5,2436,228,58,12550,716,7465,2722,20731,13266,2664
5411,5,732,816,126,2207,1813,3872,1674,7892,4020,1548
5425,5,805,180,82,2968,987,3323,1067,7278,3955,985
5440,5,5773,0,68,40810,0,14401,5841,55211,40810,5773
5467,5,480,79,32,1649,171,4061,591,5881,1820,559
5475,5,437,106,141,1553,647,870,684,3070,2200,543
5480,5,1544,939,487,4936,2528,3574,2970,11038,7464,2483
5483,5,729,216,152,2741,591,5267,1097,8599,3332,945
5490,5,2663,3250,956,9936,10487,17109,6869,37532,20423,5913
5495,5,2793,977,488,12960,4097,6743,4258,23800,17057,3770
5501,5,78,365,122,185,929,1605,565,2719,1114,443
5541,5,2522,0,92,10998,0,6989,2614,17987,10998,2522
5543,5,605,156,130,2080,414,4644,891,7138,2494,761
5576,5,1135,0,25,3803,0,3374,1160,7177,3803,1135
5579,5,7641,785,299,30987,2087,2692,8725,35766,33074,8426
5585,5,1467,2128,204,3859,5998,2264,3799,12121,9857,3595
5591,5,889,2897,169,2831,10380,2243,3955,15454,13211,3786
5604,5,2855,1494,699,11105,4125,7221,5048,22451,15230,4349
5607,5,2342,191,216,12168,984,7413,2749,20565,13152,2533
5615,5,14397,971,408,77168,6131,31474,15776,114773,83299,15368
5628,5,688,216,116,2853,784,4170,1020,7807,3637,904
5631,5,5321,1282,71,69953,7914,3730,6674,81597,77867,6603
5642,5,1261,228,108,5809,1592,8301,1597,15702,7401,1489
5647,5,891,0,65,2681,0,3599,956,6280,2681,891
5649,5,1618,344,196,7017,1483,5860,2158,14360,8500,1962
5652,5,836,376,143,2424,550,2248,1355,5222,2974,1212
5656,5,2170,0,105,6494,0,6621,2275,13115,6494,2170
5658,5,611,0,14,2111,0,820,625,2931,2111,611
5659,5,2064,828,197,6624,2710,10641,3089,19975,9334,2892
5660,5,1612,207,102,6613,680,3802,1921,11095,7293,1819
5664,5,1772,76,101,10476,216,6324,1949,17016,10692,1848
5665,5,3757,221,284,11993,975,16888,4262,29856,12968,3978
5667,5,1891,11,186,7202,5,5344,2088,12551,7207,1902
5670,5,1528,1313,434,6127,3575,8022,3275,17724,9702,2841
5674,5,669,29,59,5297,55,12632,757,17984,5352,698
5679,5,1894,720,59,10166,2271,9380,2673,21817,12437,2614
5686,5,1901,635,249,16423,1152,12767,2785,30342,17575,2536
5690,5,905,635,144,2397,2056,5049,1684,9502,4453,1540
5697,5,3284,0,18,23204,0,7036,3302,30240,23204,3284
5736,5,6509,832,1150,27176,2155,3925,8491,33256,29331,7341
5756,5,4336,1336,427,15719,4040,11825,6099,31584,19759,5672
5761,5,1880,317,194,6425,656,6606,2391,13687,7081,2197
5789,5,1875,529,110,6703,1580,6526,2514,14809,8283,2404
5790,5,3996,1856,321,12491,6885,3318,6173,22694,19376,5852
5792,5,415,51,32,3222,253,2159,498,5634,3475,466
5809,5,940,403,69,3916,974,3289,1412,8179,4890,1343
5819,5,512,103,82,1687,313,2913,697,4913,2000,615
5837,5,12425,11969,598,45402,46176,21852,24992,113430,91578,24394
5842,5,443,68,127,1979,277,4204,638,6460,2256,511
5847,5,4261,82,419,15357,174,12021,4762,27552,15531,4343
5854,5,744,208,91,3198,1743,6564,1043,11505,4941,952
5856,5,1152,0,17,3194,0,2219,1169,5413,3194,1152
5858,5,1718,185,116,7569,665,2876,2019,11110,8234,1903
5861,5,1125,694,83,4715,3086,2415,1902,10216,7801,1819
5873,5,746,613,583,3061,2235,1826,1942,7122,5296,1359
5885,5,862,34,170,3047,86,3075,1066,6208,3133,896
5887,5,5601,995,309,26286,2707,6819,6905,35812,28993,6596
5890,5,1468,599,395,6081,1758,11072,2462,18911,7839,2067
5893,5,3206,799,273,9483,2601,5350,4278,17434,12084,4005
5895,5,1969,587,656,11067,2769,10166,3212,24002,13836,2556
8001,8,178328,0,99,1114140,0,735,178427,1114875,1114140,178328
8078,8,11506,1714,126,50827,8040,2036,13346,60903,58867,13220
8137,8,4184,446,25,19868,2355,476,4655,22699,22223,4630
8141,8,2249,801,50,11161,4076,353,3100,15590,15237,3050
8296,8,10512,58,63,52090,266,2629,10633,54985,52356,10570
8372,8,1771,229,12,12343,4524,1901,2012,18768,16867,2000
8421,8,2954,2990,41,13969,12833,741,5985,27543,26802,5944
8433,8,22162,940,126,112523,4269,2836,23228,119628,116792,23102
8436,8,3398,220,40,17342,1049,758,3658,19149,18391,3618
8520,8,4202,61,23,26191,216,623,4286,27030,26407,4263
8549,8,527,395,78,2708,1849,1079,1000,5636,4557,922
8558,8,2740,209,81,13284,1346,1316,3030,15946,14630,2949
8560,8,2541,1845,63,13510,8788,1083,4449,23381,22298,4386
8573,8,7151,1263,51,41882,4944,869,8465,47695,46826,8414
8606,8,4120,1600,57,17547,7292,585,5777,25424,24839,5720
8634,8,6001,0,25,30582,0,1360,6026,31942,30582,6001
8638,8,14892,4019,170,68587,19514,3820,19081,91921,88101,18911
8675,8,2240,221,29,10878,1382,297,2490,12557,12260,2461
8685,8,5628,0,21,27153,0,1241,5649,28394,27153,5628
8758,8,98762,0,59,534204,0,853,98821,535057,534204,98762
8770,8,1752,0,12,11166,0,432,1764,11598,11166,1752
8832,8,1092,1136,169,6351,3314,2794,2397,12459,9665,2228
8849,8,1650,0,13,8967,0,547,1663,9514,8967,1650
11001,11,982853,651,988,7130351,2523,12507,984492,7145381,7132874,983504
13001,13,145418,20276,1186,796672,80541,5921,166880,883134,877213,165694
13006,13,1313,1157,507,4458,5728,8662,2977,18848,10186,2470
13030,13,945,255,222,3703,1192,4114,1422,9009,4895,1200
13042,13,1229,507,70,4485,1585,1099,1806,7169,6070,1736
13052,13,12868,2534,150,53720,10757,2254,15552,66731,64477,15402
13062,13,802,568,171,4710,3019,329,1541,8058,7729,1370
13074,13,1339,669,917,5673,2657,6088,2925,14418,8330,2008
13140,13,2675,2017,39,12660,8389,336,4731,21385,21049,4692
13160,13,654,384,352,3710,1086,2064,1390,6860,4796,1038
13188,13,2188,826,13,8673,3967,463,3027,13103,12640,3014
13212,13,1053,2552,88,4155,9639,1167,3693,14961,13794,3605
13222,13,2620,266,69,11706,1095,1016,2955,13817,12801,2886
13244,13,11778,1342,459,49869,5941,11242,13579,67052,55810,13120
13248,13,1001,861,55,4090,3513,248,1917,7851,7603,1862
13268,13,650,622,99,2732,2937,1554,1371,7223,5669,1272
13300,13,754,1489,110,3136,7172,1445,2353,11753,10308,2243
13430,13,22094,9144,658,87563,34983,4750,31896,127296,122546,31238
13433,13,2311,2996,103,10261,13132,2268,5410,25661,23393,5307
13440,13,461,1190,123,1593,4969,3145,1774,9707,6562,1651
13442,13,4867,5102,196,20140,21484,3584,10165,45208,41624,9969
13458,13,925,592,1017,3663,2516,7246,2534,13425,6179,1517
13468,13,5950,3875,270,22243,16849,3991,10095,43083,39092,9825
13473,13,1499,1051,1166,5924,3618,9135,3716,18677,9542,2550
13490,13,413,293,382,2020,1167,4657,1088,7844,3187,706
13549,13,729,2348,331,3464,12524,7343,3408,23331,15988,3077
13580,13,707,452,69,3174,1626,508,1228,5308,4800,1159
13600,13,1161,410,235,4414,1400,2300,1806,8114,5814,1571
13620,13,1250,372,5,5633,1603,129,1627,7365,7236,1622
13647,13,2538,1029,181,11287,4668,486,3748,16441,15955,3567
13650,13,507,1197,146,1874,4805,3086,1850,9765,6679,1704
13654,13,4876,504,129,20602,1497,1113,5509,23212,22099,5380
13655,13,701,563,194,2311,2308,3447,1458,8066,4619,1264
13657,13,6402,1903,185,26383,7151,1830,8490,35364,33534,8305
13667,13,1797,1125,307,7022,4640,2818,3229,14480,11662,2922
13670,13,5129,789,711,18825,2527,3046,6629,24398,21352,5918
13673,13,1407,2158,111,5338,8054,635,3676,14027,13392,3565
13683,13,3098,0,64,17096,0,1276,3162,18372,17096,3098
13688,13,3486,827,837,16899,2949,7398,5150,27246,19848,4313
13744,13,1707,1653,415,5635,5606,4000,3775,15241,11241,3360
13760,13,2074,0,18,9057,0,118,2092,9175,9057,2074
13780,13,1435,1324,72,6045,5571,1201,2831,12817,11616,2759
13810,13,1350,917,499,6129,4510,7270,2766,17909,10639,2267
13836,13,17099,713,115,91551,3283,3078,17927,97912,94834,17812
13838,13,2597,565,42,12018,2291,1223,3204,15532,14309,3162
13873,13,4017,380,61,18574,1591,963,4458,21128,20165,4397
13894,13,2468,52,76,10259,218,574,2596,11051,10477,2520
15001,15,32987,0,159,159464,0,7286,33146,166750,159464,32987
15022,15,104,0,12,314,0,1267,116,1581,314,104
15047,15,1334,233,196,5761,687,7398,1763,13846,6448,1567
15051,15,550,0,28,2378,0,3066,578,5444,2378,550
15087,15,1240,0,36,4480,0,2835,1276,7315,4480,1240
15090,15,164,0,20,393,0,1049,184,1442,393,164
15092,15,101,11,24,299,84,1511,136,1894,383,112
15097,15,692,0,47,2260,0,2669,739,4929,2260,692
15104,15,222,0,24,672,0,3796,246,4468,672,222
15106,15,161,0,14,464,0,1570,175,2034,464,161
15109,15,195,0,32,703,0,3536,227,4239,703,195
15114,15,155,0,7,410,0,486,162,896,410,155
15131,15,100,83,14,234,238,2612,197,3084,472,183
15135,15,196,78,41,651,236,1817,315,2704,887,274
15162,15,479,0,13,1614,0,2021,492,3635,1614,479
15172,15,472,0,14,1150,0,1672,486,2822,1150,472
15176,15,9358,0,54,45768,0,5616,9412,51384,45768,9358
15180,15,360,85,59,847,164,2570,504,3581,1011,445
15183,15,608,0,230,1899,0,5831,838,7730,1899,608
15185,15,309,0,49,1074,0,3936,358,5010,1074,309
15187,15,113,0,16,470,0,2310,129,2780,470,113
15189,15,406,0,12,1207,0,3283,418,4490,1207,406
15204,15,345,22,44,1280,140,7917,411,9337,1420,367
15212,15,287,0,473,730,0,2289,760,3019,730,287
15215,15,452,0,12,1552,0,924,464,2476,1552,452
15218,15,166,4,23,461,18,2108,193,2587,479,170
15223,15,672,188,606,2124,568,2089,1466,4781,2692,860
15224,15,418,0,8,1454,0,1920,426,3374,1454,418
15226,15,111,34,10,250,90,1280,155,1620,340,145
15232,15,88,21,37,331,77,3939,146,4347,408,109
15236,15,164,0,36,614,0,1051,200,1665,614,164
15238,15,21352,660,108,103425,3077,10203,22120,116705,106502,22012
15244,15,683,0,23,2138,0,1794,706,3932,2138,683
15248,15,461,0,18,1227,0,1369,479,2596,1227,461
15272,15,718,0,34,2485,0,4035,752,6520,2485,718
15276,15,429,51,24,1138,135,1911,504,3184,1273,480
15293,15,198,0,24,555,0,2189,222,2744,555,198
15296,15,405,0,27,1321,0,3074,432,4395,1321,405
15299,15,3403,0,29,10798,0,3174,3432,13972,10798,3403
15317,15,232,0,12,594,0,1170,244,1764,594,232
15322,15,2108,0,10,6430,0,1588,2118,8018,6430,2108
15325,15,413,0,14,1004,0,2082,427,3086,1004,413
15332,15,439,0,50,1222,0,1917,489,3139,1222,439
15362,15,430,0,8,1159,0,785,438,1944,1159,430
15367,15,558,0,14,1684,0,4618,572,6302,1684,558
15368,15,318,30,28,988,155,2391,376,3534,1143,348
15377,15,348,0,38,1070,0,1998,386,3068,1070,348
15380,15,347,0,10,920,0,1364,357,2284,920,347
15401,15,122,0,86,328,0,627,208,955,328,122
15403,15,486,26,20,1211,71,1489,532,2771,1282,512
15407,15,1949,40,79,7850,74,6311,2068,14235,7924,1989
15425,15,289,52,50,982,115,2419,391,3516,1097,341
15442,15,164,122,97,699,425,4223,383,5347,1124,286
15455,15,1520,0,44,4889,0,3303,1564,8192,4889,1520
15464,15,645,0,47,1992,0,2308,692,4300,1992,645
15466,15,919,0,43,2326,0,1566,962,3892,2326,919
15469,15,2993,0,81,11012,0,9631,3074,20643,11012,2993
15476,15,172,0,18,715,0,4507,190,5222,715,172
15480,15,1229,0,112,5326,0,2627,1341,7953,5326,1229
15491,15,1316,1922,29,4936,6997,2713,3267,14646,11933,3238
15494,15,340,0,10,971,0,4019,350,4990,971,340
15500,15,131,0,19,400,0,2392,150,2792,400,131
15507,15,526,150,212,3348,468,3171,888,6987,3816,676
15511,15,191,0,8,494,0,1766,199,2260,494,191
15514,15,470,68,45,1246,180,1499,583,2925,1426,538
15516,15,5450,130,84,19314,393,11363,5664,31070,19707,5580
15518,15,251,143,35,909,373,645,429,1927,1282,394
15522,15,227,0,10,764,0,853,237,1617,764,227
15531,15,650,0,51,2029,0,4326,701,6355,2029,650
15533,15,142,28,295,443,95,1512,465,2050,538,170
15537,15,770,4,25,2636,15,1388,799,4039,2651,774
15542,15,114,0,37,2245,0,4359,151,6604,2245,114
15550,15,203,0,61,525,0,1051,264,1576,525,203
15572,15,9356,2760,735,31657,7126,5056,12851,43839,38783,12116
15580,15,392,27,77,1277,453,2455,496,4185,1730,419
15599,15,1284,105,23,3823,110,4754,1412,8687,3933,1389
15600,15,575,18,85,2214,70,5013,678,7297,2284,593
15621,15,198,27,40,570,71,1566,265,2207,641,225
15632,15,320,32,65,943,85,10125,417,11153,1028,352
15638,15,616,0,60,2445,0,2363,676,4808,2445,616
15646,15,1481,99,71,6948,367,10166,1651,17481,7315,1580
15660,15,305,0,14,675,0,879,319,1554,675,305
15664,15,275,0,30,946,0,3712,305,4658,946,275
15667,15,738,125,37,2122,471,1936,900,4529,2593,863
15673,15,486,0,21,1163,0,2143,507,3306,1163,486
15676,15,123,0,20,408,0,2489,143,2897,408,123
15681,15,28,172,55,681,1477,3648,255,5806,2158,200
15686,15,790,80,28,2368,289,4153,898,6810,2657,870
15690,15,653,0,36,1967,0,1122,689,3089,1967,653
15693,15,2343,5,30,6887,12,3933,2378,10832,6899,2348
15696,15,295,0,11,983,0,1936,306,2919,983,295
15720,15,427,18,30,659,20,1268,475,1947,679,445
15723,15,115,0,7,291,0,752,122,1043,291,115
15740,15,321,0,45,1114,0,5531,366,6645,1114,321
15753,15,1545,0,42,6148,0,2305,1587,8453,6148,1545
15755,15,374,11,76,1354,41,5723,461,7118,1395,385
15757,15,1115,33,30,4212,137,3138,1178,7487,4349,1148
15759,15,24587,428,132,106066,1456,11917,25147,119439,107522,25015
15761,15,263,0,13,597,0,1766,276,2363,597,263
15762,15,149,0,11,457,0,2129,160,2586,457,149
15763,15,260,97,68,831,462,6651,425,7944,1293,357
15764,15,343,0,24,1411,0,4441,367,5852,1411,343
15774,15,35,0,23,579,0,1976,58,2555,579,35
15776,15,531,0,28,2081,0,3672,559,5753,2081,531
15778,15,263,0,9,659,0,2819,272,3478,659,263
15790,15,506,80,40,1482,173,3483,626,5138,1655,586
15798,15,448,0,10,1046,0,2380,458,3426,1046,448
15804,15,549,0,25,1644,0,6291,574,7935,1644,549
15806,15,1128,161,46,4176,820,6011,1335,11007,4996,1289
15808,15,283,0,30,727,0,2140,313,2867,727,283
15810,15,185,7,10,908,37,2206,202,3151,945,192
15814,15,707,0,41,4202,0,4502,748,8704,4202,707
15816,15,176,0,25,607,0,3617,201,4224,607,176
15820,15,290,88,6,1008,424,2091,384,3523,1432,378
15822,15,289,0,50,769,0,3754,339,4523,769,289
15832,15,68,0,12,251,0,1267,80,1518,251,68
15835,15,658,0,14,2050,0,3781,672,5831,2050,658
15837,15,616,0,65,2300,0,5836,681,8136,2300,616
15839,15,24,9,15,169,118,1506,48,1793,287,33
15842,15,357,0,31,1012,0,5893,388,6905,1012,357
15861,15,453,324,34,2328,1212,10425,811,13965,3540,777
15879,15,236,0,13,413,0,2165,249,2578,413,236
15897,15,387,0,43,1058,0,3209,430,4267,1058,387
17001,17,66148,2601,618,370232,8402,15543,69367,394177,378634,68749
17013,17,2643,186,80,10234,1615,8663,2909,20512,11849,2829
17042,17,4499,187,201,18164,613,12512,4887,31289,18777,4686
17050,17,1212,55,31,6322,212,3300,1298,9834,6534,1267
17088,17,790,138,38,4271,669,4000,966,8940,4940,928
17174,17,9068,437,61,43005,1435,3841,9566,48281,44440,9505
17272,17,701,247,60,3449,1202,4928,1008,9579,4651,948
17380,17,19010,1543,398,61585,4233,3054,20951,68872,65818,20553
17388,17,93,63,33,1863,1357,2104,189,5324,3220,156
17433,17,1684,84,43,9253,629,6573,1811,16455,9882,1768
17442,17,228,775,21,950,3863,3611,1024,8424,4813,1003
17444,17,552,6,26,5659,89,6319,584,12067,5748,558
17446,17,311,219,33,676,446,959,563,2081,1122,530
17486,17,2602,551,209,11183,1361,7746,3362,20290,12544,3153
17495,17,1185,155,92,3943,435,1559,1432,5937,4378,1340
17513,17,1912,505,64,6351,1347,5315,2481,13013,7698,2417
17524,17,1411,1015,51,4655,5143,3682,2477,13480,9798,2426
17541,17,1773,932,100,6556,2473,8020,2805,17049,9029,2705
17614,17,3651,1273,335,17121,8230,22515,5259,47866,25351,4924
17616,17,1145,126,53,3808,558,5467,1324,9833,4366,1271
17653,17,2499,465,114,10349,1054,4997,3078,16400,11403,2964
17662,17,1145,942,169,5209,3216,8946,2256,17371,8425,2087
17665,17,359,119,71,1200,124,3190,549,4514,1324,478
17777,17,2889,273,104,12849,1236,12365,3266,26450,14085,3162
17867,17,1373,351,162,3962,1022,3158,1886,8142,4984,1724
17873,17,10997,919,285,54176,3153,5203,12201,62532,57329,11916
17877,17,2869,0,26,10655,0,1761,2895,12416,10655,2869
18001,18,43462,610,2028,138269,1590,12333,46100,152192,139859,44072
18029,18,781,120,82,1976,273,2049,983,4298,2249,901
18094,18,1347,59,148,5680,345,2690,1554,8715,6025,1406
18150,18,3973,471,2374,14967,1223,10648,6818,26838,16190,4444
18205,18,1717,86,92,5202,216,1949,1895,7367,5418,1803
18247,18,3989,424,299,12455,1039,4059,4712,17553,13494,4413
18256,18,2169,154,420,7610,495,4568,2743,12673,8105,2323
18410,18,727,875,868,2284,2332,6797,2470,11413,4616,1602
18460,18,320,776,225,945,1548,2632,1321,5125,2493,1096
18479,18,414,0,64,1834,0,1510,478,3344,1834,414
18592,18,4086,226,1107,14192,734,8604,5419,23530,14926,4312
18610,18,1700,868,511,6076,2084,2777,3079,10937,8160,2568
18753,18,5921,758,3104,21206,2653,16775,9783,40634,23859,6679
18756,18,956,228,1056,2699,827,5888,2240,9414,3526,1184
18785,18,1205,70,429,3178,141,1904,1704,5223,3319,1275
18860,18,758,190,158,2197,428,3038,1106,5663,2625,948
19001,19,65312,3931,1613,228339,17625,25243,70856,271207,245964,69243
19022,19,557,457,198,1201,1084,14214,1212,16499,2285,1014
19050,19,497,610,339,2352,3770,13613,1446,19735,6122,1107
19075,19,1300,540,254,5212,2357,11306,2094,18875,7569,1840
19100,19,1561,1340,383,4515,3610,27437,3284,35562,8125,2901
19110,19,298,1267,576,1134,6532,14264,2141,21930,7666,1565
19130,19,672,476,480,1952,1613,28602,1628,32167,3565,1148
19137,19,391,315,262,1371,1627,12553,968,15551,2998,706
19142,19,1523,1012,447,4962,4030,7138,2982,16130,8992,2535
19212,19,3670,212,189,12493,701,7710,4071,20904,13194,3882
19256,19,494,746,1112,2536,3219,29235,2352,34990,5755,1240
19290,19,349,57,12,1180,431,3476,418,5087,1611,406
19300,19,1626,2272,121,5962,10442,2076,4019,18480,16404,3898
19318,19,3406,206,1957,13401,748,9326,5569,23475,14149,3612
19355,19,333,635,680,1193,3550,21590,1648,26333,4743,968
19364,19,302,0,122,1069,0,4288,424,5357,1069,302
19392,19,612,97,158,1614,409,7853,867,9876,2023,709
19397,19,423,1330,220,1026,3656,14983,1973,19665,4682,1753
19418,19,530,391,1982,1762,1290,11234,2903,14286,3052,921
19450,19,1786,1391,272,5642,3797,5341,3449,14780,9439,3177
19455,19,4706,1272,191,17734,4352,5649,6169,27735,22086,5978
19473,19,913,378,614,2200,1126,14845,1905,18171,3326,1291
19513,19,1246,303,43,4379,1609,2770,1592,8758,5988,1549
19517,19,783,822,668,2843,4461,20400,2273,27704,7304,1605
19532,19,3448,1864,534,11613,5703,10830,5846,28146,17316,5312
19533,19,647,294,184,1910,1022,4098,1125,7030,2932,941
19548,19,2966,259,239,12522,776,19943,3464,33241,13298,3225
19573,19,7258,1157,43,35442,3916,621,8458,39979,39358,8415
19585,19,462,448,328,1645,2101,7489,1238,11235,3746,910
19622,19,339,248,77,1017,904,7400,664,9321,1921,587
19693,19,223,654,156,592,1921,7228,1033,9741,2513,877
19698,19,12368,2520,542,46694,10229,31574,15430,88497,56923,14888
19701,19,303,273,930,581,780,2903,1506,4264,1361,576
19743,19,1253,220,1232,4247,842,14345,2705,19434,5089,1473
19760,19,168,377,217,512,1393,9949,762,11854,1905,545
19780,19,1494,171,191,5725,1288,12565,1856,19578,7013,1665
19785,19,503,153,80,1104,359,4715,736,6178,1463,656
19807,19,3725,170,295,13408,580,18147,4190,32135,13988,3895
19809,19,1422,770,1902,6128,2685,7729,4094,16542,8813,2192
19821,19,420,336,331,1882,2036,14834,1087,18752,3918,756
19824,19,208,170,292,780,1747,11520,670,14047,2527,378
19845,19,3101,444,128,13669,1647,3373,3673,18689,15316,3545
20001,20,73069,8692,3406,398977,31509,13278,85167,443764,430486,81761
20011,20,24726,1362,250,83672,4773,6846,26338,95291,88445,26088
20013,20,11247,1553,348,47700,5890,4049,13148,57639,53590,12800
20032,20,2031,1110,156,9287,4951,4169,3297,18407,14238,3141
20045,20,3966,180,224,15722,524,2686,4370,18932,16246,4146
20060,20,8004,128,171,34558,543,1485,8303,36586,35101,8132
20175,20,3205,2879,318,12604,11615,5906,6402,30125,24219,6084
20178,20,4420,2708,287,16370,8674,1873,7415,26917,25044,7128
20228,20,6058,1865,200,24797,6585,3388,8123,34770,31382,7923
20238,20,5769,852,231,22282,3075,3156,6852,28513,25357,6621
20250,20,1823,7721,138,6532,25110,2640,9682,34282,31642,9544
20295,20,2402,926,54,8191,3165,1081,3382,12437,11356,3328
20310,20,378,162,66,1230,631,2172,606,4033,1861,540
20383,20,886,1407,89,5067,6420,3269,2382,14756,11487,2293
20400,20,7655,2194,185,28312,5579,3176,10034,37067,33891,9849
20443,20,1660,0,50,8071,0,1201,1710,9272,8071,1660
20517,20,4028,514,88,12960,1742,2096,4630,16798,14702,4542
20550,20,3903,970,71,12889,3096,2452,4944,18437,15985,4873
20570,20,2165,98,492,8257,524,4261,2755,13042,8781,2263
20614,20,1843,793,117,6591,2842,4955,2753,14388,9433,2636
20621,20,4520,764,277,18721,4083,2817,5561,25621,22804,5284
20710,20,4117,478,112,18426,1749,2791,4707,22966,20175,4595
20750,20,2492,1450,81,10288,5977,2221,4023,18486,16265,3942
20770,20,3068,1549,150,11334,6125,2941,4767,20400,17459,4617
20787,20,1500,1497,149,5950,5529,2571,3146,14050,11479,2997
23001,23,73161,9070,1809,352018,37742,40422,84040,430182,389760,82231
23068,23,6758,884,302,24422,3485,8850,7944,36757,27907,7642
23079,23,1809,838,97,7370,5234,5734,2744,18338,12604,2647
23090,23,1035,386,136,3831,2076,8908,1557,14815,5907,1421
23162,23,13305,5069,274,56826,21633,17300,18648,95759,78459,18374
23168,23,513,933,89,3121,5950,3922,1535,12993,9071,1446
23182,23,4319,1374,217,19963,7874,14710,5910,42547,27837,5693
23189,23,5951,2603,481,22436,10741,22941,9035,56118,33177,8554
23300,23,1255,927,79,5491,4743,5785,2261,16019,10234,2182
23350,23,2990,360,170,11090,1400,1202,3520,13692,12490,3350
23417,23,12399,5355,562,49454,21209,27661,18316,98324,70663,17754
23419,23,840,848,194,3516,2971,9380,1882,15867,6487,1688
23464,23,2539,549,39,10757,2590,2847,3127,16194,13347,3088
23466,23,15305,1723,416,55833,6800,8944,17444,71577,62633,17028
23500,23,1828,966,263,5764,3606,15648,3057,25018,9370,2794
23555,23,9689,1823,388,39570,7390,12355,11900,59315,46960,11512
23570,23,2275,1377,400,8846,5623,12473,4052,26942,14469,3652
23574,23,884,711,237,3787,2972,12534,1832,19293,6759,1595
23580,23,2582,2169,996,11610,8531,14850,5747,34991,20141,4751
23586,23,1889,379,69,7122,2962,4592,2337,14676,10084,2268
23660,23,12160,3672,463,51862,15205,26594,16295,93661,67067,15832
23670,23,1955,969,875,8505,5315,24238,3799,38058,13820,2924
23672,23,3424,2482,273,14933,8680,5334,6179,28947,23613,5906
23675,23,2169,1512,133,8599,6034,14751,3814,29384,14633,3681
23678,23,1234,734,178,4280,5181,13970,2146,23431,9461,1968
23682,23,1259,474,164,5107,2234,3454,1897,10795,7341,1733
23686,23,2319,2312,300,8561,11331,20589,4931,40481,19892,4631
23807,23,10609,1951,1578,41321,8463,28687,14138,78471,49784,12560
23815,23,284,445,89,4663,3587,4216,818,12466,8250,729
23855,23,3960,936,988,14399,3398,12655,5884,30452,17797,4896
25001,25,3549,0,29,8282,0,2109,3578,10391,8282,3549
25019,25,439,296,25,1690,908,3307,760,5905,2598,735
25035,25,2370,226,69,5341,895,5855,2665,12091,6236,2596
25040,25,1101,469,42,4050,1697,6352,1612,12099,5747,1570
25053,25,992,23,47,3990,73,5522,1062,9585,4063,1015
25086,25,148,360,120,355,853,508,628,1716,1208,508
25095,25,158,58,17,391,91,1739,233,2221,482,216
25099,25,1694,0,45,7636,0,2003,1739,9639,7636,1694
25120,25,271,0,86,1106,0,3163,357,4269,1106,271
25123,25,956,76,34,3426,230,5517,1066,9173,3656,1032
25126,25,7092,2769,206,53438,17001,10072,10067,80511,70439,9861
25148,25,922,511,209,2705,1109,6446,1642,10260,3814,1433
25151,25,1510,0,27,6574,0,8854,1537,15428,6574,1510
25154,25,636,0,40,2073,0,5252,676,7325,2073,636
25168,25,302,0,17,843,0,2473,319,3316,843,302
25175,25,14906,2202,282,104004,13682,10982,17390,128668,117686,17108
25178,25,557,38,72,2610,83,5926,667,8619,2693,595
25181,25,1133,5,35,3938,64,6358,1173,10360,4002,1138
25183,25,1236,0,92,10233,0,9367,1328,19600,10233,1236
25200,25,1436,905,52,7585,4509,8699,2393,20793,12094,2341
25214,25,4216,0,395,20129,0,11164,4611,31293,20129,4216
25224,25,337,0,40,1128,0,5874,377,7002,1128,337
25245,25,2805,611,53,10034,1726,10739,3469,22499,11760,3416
25258,25,165,134,46,443,234,2781,345,3458,677,299
25260,25,3229,100,25,18893,411,2557,3354,21861,19304,3329
25269,25,20573,977,159,123019,5141,6632,21709,134792,128160,21550
25279,25,1138,53,44,4414,157,6171,1235,10742,4571,1191
25281,25,351,48,24,1172,163,4221,423,5556,1335,399
25286,25,16271,85,72,88384,479,1764,16428,90627,88863,16356
25288,25,69,172,14,167,751,3926,255,4844,918,241
25290,25,26486,1440,105,111538,4770,15243,28031,131551,116308,27926
25293,25,513,56,100,1503,156,2684,669,4343,1659,569
25295,25,1413,146,24,11154,808,4625,1583,16587,11962,1559
25297,25,929,5,66,3152,4,4902,1000,8058,3156,934
25299,25,250,11,27,638,20,2368,288,3026,658,261
25307,25,24074,732,194,86672,2784,2012,25000,91468,89456,24806
25312,25,409,247,19,1839,1007,4051,675,6897,2846,656
25317,25,978,0,28,5921,0,6472,1006,12393,5921,978
25320,25,3661,1643,211,12300,4676,7486,5515,24462,16976,5304
25322,25,1258,112,104,6091,502,8341,1474,14934,6593,1370
25324,25,409,118,32,1169,285,516,559,1970,1454,527
25326,25,640,0,40,2209,0,3924,680,6133,2209,640
25328,25,346,22,14,1014,29,2553,382,3596,1043,368
25335,25,338,336,122,1721,1145,2938,796,5804,2866,674
25339,25,337,35,61,890,122,2292,433,3304,1012,372
25368,25,212,0,85,788,0,1236,297,2024,788,212
25372,25,291,224,47,674,367,4155,562,5196,1041,515
25377,25,2550,702,216,13247,2910,12220,3468,28377,16157,3252
25386,25,4236,614,60,16157,1856,10866,4910,28879,18013,4850
25394,25,1358,0,55,3638,0,4062,1413,7700,3638,1358
25398,25,341,0,48,887,0,4518,389,5405,887,341
25402,25,1171,76,46,5427,432,7189,1293,13048,5859,1247
25407,25,664,0,50,2782,0,6631,714,9413,2782,664
25426,25,314,0,51,1541,0,4474,365,6015,1541,314
25430,25,16403,825,66,99999,4684,4121,17294,108804,104683,17228
25436,25,267,0,19,804,0,2524,286,3328,804,267
25438,25,1209,176,213,3816,295,3112,1598,7223,4111,1385
25473,25,18363,23,139,126806,405,1630,18525,128841,127211,18386
25483,25,826,0,23,1552,0,544,849,2096,1552,826
25486,25,1295,478,65,6307,2224,3662,1838,12193,8531,1773
25488,25,888,346,228,2694,1066,3154,1462,6914,3760,1234
25489,25,235,126,12,616,362,2079,373,3057,978,361
25491,25,587,112,12,1751,129,3308,711,5188,1880,699
25506,25,300,60,52,1127,195,2782,412,4104,1322,360
25513,25,3471,90,113,12424,184,11012,3674,23620,12608,3561
25518,25,164,149,38,481,367,2993,351,3841,848,313
25524,25,462,0,87,1042,0,3678,549,4720,1042,462
25530,25,755,534,172,3389,1771,2830,1461,7990,5160,1289
25535,25,644,45,40,2756,153,5770,729,8679,2909,689
25572,25,3556,344,433,10967,1073,2604,4333,14644,12040,3900
25580,25,204,45,119,507,83,1923,368,2513,590,249
25592,25,137,268,12,378,796,3273,417,4447,1174,405
25594,25,380,166,63,1241,1035,2652,609,4928,2276,546
25596,25,247,254,53,631,719,4747,554,6097,1350,501
25599,25,1210,0,131,3505,0,4014,1341,7519,3505,1210
25612,25,2865,682,84,5931,1413,3435,3631,10779,7344,3547
25645,25,266,471,36,832,1436,7934,773,10202,2268,737
25649,25,921,13,32,3190,27,4179,966,7396,3217,934
25653,25,210,121,77,526,366,3151,408,4043,892,331
25658,25,861,0,43,3969,0,5389,904,9358,3969,861
25662,25,964,584,92,2607,1497,3385,1640,7489,4104,1548
25718,25,623,44,24,2417,134,6715,691,9266,2551,667
25736,25,789,555,59,3381,2569,5093,1403,11043,5950,1344
25740,25,4466,926,45,23535,3542,4412,5437,31489,27077,5392
25743,25,2249,266,88,6801,1427,12316,2603,20544,8228,2515
25745,25,1789,122,23,7057,374,4047,1934,11478,7431,1911
25754,25,90694,611,184,639242,1899,3151,91489,644292,641141,91305
25758,25,3014,232,217,17156,1272,6337,3463,24765,18428,3246
25769,25,1619,388,63,7202,1681,5946,2070,14829,8883,2007
25772,25,1385,588,101,7166,2370,5856,2074,15392,9536,1973
25777,25,564,19,22,1629,60,3027,605,4716,1689,583
25779,25,525,0,16,2142,0,3920,541,6062,2142,525
25781,25,436,108,20,1851,449,2953,564,5253,2300,544
25785,25,1175,889,75,6270,4827,9455,2139,20552,11097,2064
25793,25,338,102,43,1240,383,5071,483,6694,1623,440
25797,25,218,410,68,563,1426,6057,696,8046,1989,628
25799,25,1042,367,96,8534,2698,9116,1505,20348,11232,1409
25805,25,161,188,18,529,597,2812,367,3938,1126,349
25807,25,168,0,16,476,0,1958,184,2434,476,168
25815,25,3524,486,84,8523,1043,3870,4094,13436,9566,4010
25817,25,2356,2521,133,15270,18102,5973,5010,39345,33372,4877
25823,25,249,93,47,624,237,2662,389,3523,861,342
25839,25,239,191,116,1021,1018,5156,546,7195,2039,430
25841,25,297,0,37,1022,0,5358,334,6380,1022,297
25843,25,6424,685,105,29678,2475,7543,7214,39696,32153,7109
25845,25,850,40,29,3615,110,3175,919,6900,3725,890
25851,25,763,0,9,2324,0,1693,772,4017,2324,763
25862,25,390,93,37,1102,195,4739,520,6036,1297,483
25867,25,375,13,12,1422,26,2357,400,3805,1448,388
25871,25,200,0,24,583,0,1107,224,1690,583,200
25873,25,846,31,54,6342,122,9342,931,15806,6464,877
25875,25,5075,242,76,17568,743,7323,5393,25634,18311,5317
25878,25,1395,258,104,4220,477,7819,1757,12516,4697,1653
25885,25,863,340,253,2596,879,7398,1456,10873,3475,1203
25898,25,271,265,20,1192,760,2257,556,4209,1952,536
25899,25,17602,2975,85,105411,16889,6638,20662,128938,122300,20577
27001,27,26525,972,502,106640,2859,7921,27999,117420,109499,27497
27006,27,1613,802,1130,6504,2185,3376,3545,12065,8689,2415
27025,27,428,208,2015,2724,920,15162,2651,18806,3644,636
27050,27,570,765,93,2531,2701,260,1428,5492,5232,1335
27073,27,824,190,759,2502,586,5618,1773,8706,3088,1014
27075,27,919,625,40,5440,2689,624,1584,8753,8129,1544
27077,27,853,457,507,3801,1931,3440,1817,9172,5732,1310
27099,27,243,1140,718,1083,4429,5617,2101,11129,5512,1383
27135,27,693,692,61,2594,2338,558,1446,5490,4932,1385
27150,27,410,273,865,1775,1161,9021,1548,11957,2936,683
27160,27,826,74,268,2922,170,906,1168,3998,3092,900
27205,27,2517,631,197,9495,1670,1034,3345,12199,11165,3148
27245,27,564,83,164,2497,1129,3376,811,7002,3626,647
27250,27,297,359,342,1393,1338,2952,998,5683,2731,656
27361,27,6151,314,556,20717,814,5747,7021,27278,21531,6465
27372,27,510,202,324,1586,530,1896,1036,4012,2116,712
27413,27,963,321,197,3264,1526,1004,1481,5794,4790,1284
27425,27,234,457,330,857,1930,4279,1021,7066,2787,691
27430,27,360,1232,397,1643,5837,3267,1989,10747,7480,1592
27450,27,691,25,787,2534,79,6378,1503,8991,2613,716
27491,27,920,323,449,3302,1446,3339,1692,8087,4748,1243
27495,27,240,123,118,995,510,1028,481,2533,1505,363
27580,27,443,502,155,1505,1435,1485,1100,4425,2940,945
27600,27,694,895,152,2190,3854,1230,1741,7274,6044,1589
27615,27,2721,3941,2669,12732,13504,21517,9331,47753,26236,6662
27660,27,412,345,406,1341,941,2357,1163,4639,2282,757
27745,27,222,472,31,590,1605,248,725,2443,2195,694
27787,27,2801,846,514,9840,2940,3161,4161,15941,12780,3647
27800,27,1122,1097,649,4173,3944,3187,2868,11304,8117,2219
27810,27,793,771,139,2857,2640,805,1703,6302,5497,1564
41001,41,82871,3868,1137,293148,11857,7682,87876,312687,305005,86739
41006,41,873,375,535,4564,1908,18075,1783,24547,6472,1248
41013,41,1758,81,45,5606,276,2685,1884,8567,5882,1839
41016,41,3270,437,248,9945,1067,3565,3955,14577,11012,3707
41020,41,3412,456,1519,9936,1221,8831,5387,19988,11157,3868
41026,41,851,87,158,2378,270,1156,1096,3804,2648,938
41078,41,1153,0,68,3452,0,2924,1221,6376,3452,1153
41132,41,6759,625,162,23385,1743,4923,7546,30051,25128,7384
41206,41,825,222,1400,2096,319,4542,2447,6957,2415,1047
41244,41,409,160,61,1350,478,1901,630,3729,1828,569
41298,41,9498,1717,751,36137,6138,22944,11966,65219,42275,11215
41306,41,2854,1246,249,9268,4052,9158,4349,22478,13320,4100
41319,41,1531,524,113,5114,2179,8566,2168,15859,7293,2055
41349,41,1765,0,35,5154,0,1401,1800,6555,5154,1765
41357,41,1064,611,214,2564,1181,5285,1889,9030,3745,1675
41359,41,1501,227,259,6049,924,17565,1987,24538,6973,1728
41378,41,1358,111,199,4761,558,7075,1668,12394,5319,1469
41396,41,6707,834,608,23910,2952,24817,8149,51679,26862,7541
41483,41,695,112,88,2421,499,3142,895,6062,2920,807
41503,41,621,360,87,2355,1431,7324,1068,11110,3786,981
41518,41,901,48,66,2643,139,3615,1015,6397,2782,949
41524,41,3480,1762,357,11678,5008,7379,5599,24065,16686,5242
41530,41,494,0,108,1718,0,8699,602,10417,1718,494
41548,41,1351,83,62,4251,301,7634,1496,12186,4552,1434
41551,41,18013,1978,1353,71100,6661,40948,21344,118709,77761,19991
41615,41,3231,1189,241,11464,4393,5063,4661,20920,15857,4420
41660,41,404,80,92,1811,351,7889,576,10051,2162,484
41668,41,3103,534,335,10801,1852,19650,3972,32303,12653,3637
41676,41,755,95,101,2522,332,7348,951,10202,2854,850
41770,41,1104,665,841,3994,2149,11156,2610,17299,6143,1769
41791,41,1464,788,204,5118,2583,8320,2456,16021,7701,2252
41797,41,1677,525,129,5243,1515,2982,2331,9740,6758,2202
41799,41,1687,500,220,5146,1060,3982,2407,10188,6206,2187
41801,41,1249,0,99,3936,0,3408,1348,7344,3936,1249
41807,41,1914,435,75,7378,2231,11273,2424,20882,9609,2349
41872,41,810,1164,214,2373,3511,1052,2188,6936,5884,1974
41885,41,1994,0,246,6173,0,1166,2240,7339,6173,1994
44001,44,26507,3657,1362,117717,15266,9071,31526,142054,132983,30164
44035,44,3041,419,383,14600,2162,3087,3843,19849,16762,3460
44078,44,2316,788,132,15138,4630,1765,3236,21533,19768,3104
44090,44,1053,3913,358,4319,16076,3225,5324,23620,20395,4966
44098,44,1538,1001,281,5510,3950,2083,2820,11543,9460,2539
44110,44,1444,0,23,6249,0,704,1467,6953,6249,1444
44279,44,8243,1134,146,34697,3954,1863,9523,40514,38651,9377
44378,44,3137,432,527,10902,1804,3160,4096,15866,12706,3569
44420,44,426,81,29,1948,246,757,536,2951,2194,507
44430,44,16208,569,896,93405,3385,10829,17673,107619,96790,16777
44560,44,1802,294,1259,6639,2118,15096,3355,23853,8757,2096
44650,44,7542,3026,321,29559,10586,2686,10889,42831,40145,10568
44847,44,1962,297,3002,5452,1469,31680,5261,38601,6921,2259
44855,44,1992,0,33,9250,0,905,2025,10155,9250,1992
44874,44,4235,0,41,23838,0,1086,4276,24924,23838,4235
47001,47,98598,7190,1554,436601,26474,9808,107342,472883,463075,105788
47030,47,2352,908,76,9355,3430,1315,3336,14100,12785,3260
47053,47,5161,1778,211,22571,9275,2459,7150,34305,31846,6939
47058,47,4182,1373,137,18879,5757,3620,5692,28256,24636,5555
47161,47,1083,742,20,5181,3858,186,1845,9225,9039,1825
47170,47,2957,528,98,12114,2521,3554,3583,18189,14635,3485
47189,47,22599,1028,590,104266,5049,6823,24217,116138,109315,23627
47205,47,1118,1529,9,4017,5513,124,2656,9654,9530,2647
47245,47,8146,3492,492,37525,16194,4977,12130,58696,53719,11638
47258,47,1465,2713,57,6168,10376,724,4235,17268,16544,4178
47268,47,2729,378,67,15474,2777,1079,3174,19330,18251,3107
47288,47,14273,468,252,55287,1782,2470,14993,59539,57069,14741
47318,47,1714,2074,272,8193,9540,7551,4060,25284,17733,3788
47460,47,1541,1327,142,7730,5572,4125,3010,17427,13302,2868
47541,47,509,1199,31,2396,4960,200,1739,7556,7356,1708
47545,47,1201,574,159,5583,2313,3149,1934,11045,7896,1775
47551,47,5638,2537,240,20371,9852,4115,8415,34338,30223,8175
47555,47,9371,1205,204,43076,6976,5995,10780,56047,50052,10576
47570,47,1598,2870,72,8561,17143,560,4540,26264,25704,4468
47605,47,1210,771,44,6272,2724,559,2025,9555,8996,1981
47660,47,1062,919,255,4491,3918,5590,2236,13999,8409,1981
47675,47,1784,648,36,6303,2626,415,2468,9344,8929,2432
47692,47,1437,1603,211,5747,7146,5946,3251,18839,12893,3040
47703,47,378,1650,124,1468,7201,2602,2152,11271,8669,2028
47707,47,2628,1025,206,12982,5105,4593,3859,22680,18087,3653
47720,47,1122,499,130,5904,1914,1511,1751,9329,7818,1621
47745,47,2759,1776,378,13274,8522,3965,4913,25761,21796,4535
47798,47,1579,1008,86,6281,4350,1710,2673,12341,10631,2587
47960,47,826,867,39,3655,3950,781,1732,8386,7605,1693
47980,47,994,12251,380,4338,55909,6446,13625,66693,60247,13245
50001,50,119194,4507,1436,416145,14219,15464,125137,445828,430364,123701
50006,50,18037,979,221,59880,4098,9879,19237,73857,63978,19016
50110,50,1074,82,141,4298,224,1313,1297,5835,4522,1156
50124,50,862,300,170,2725,925,1368,1332,5018,3650,1162
50150,50,1354,808,127,6128,3095,4276,2289,13499,9223,2162
50223,50,1384,76,131,4478,244,1550,1591,6272,4722,1460
50226,50,4020,799,171,14366,2625,4126,4990,21117,16991,4819
50245,50,164,127,28,438,283,665,319,1386,721,291
50251,50,982,461,210,2849,1205,3195,1653,7249,4054,1443
50270,50,428,156,22,1332,718,1548,606,3598,2050,584
50287,50,2028,613,187,6665,1698,3153,2828,11516,8363,2641
50313,50,17973,1105,195,53603,3580,6340,19273,63523,57183,19078
50318,50,2440,64,92,9499,215,4094,2596,13808,9714,2504
50325,50,575,137,614,2286,469,2967,1326,5722,2755,712
50330,50,1233,189,196,4060,398,4819,1618,9277,4458,1422
50350,50,1433,762,1734,4036,1699,16819,3929,22554,5735,2195
50370,50,499,401,920,1548,1132,5028,1820,7708,2680,900
50400,50,1122,141,75,4451,523,5395,1338,10369,4974,1263
50450,50,648,162,470,3229,739,3848,1280,7816,3968,810
50568,50,3620,1072,803,19983,2698,7156,5495,29837,22681,4692
50573,50,5205,1533,544,18007,4062,5318,7282,27387,22069,6738
50577,50,1265,287,338,3861,760,4059,1890,8680,4621,1552
50590,50,1635,234,962,6111,250,4621,2831,10982,6361,1869
50606,50,2928,0,264,11986,0,5277,3192,17263,11986,2928
50680,50,1802,1130,189,5924,4225,1180,3121,11329,10149,2932
50683,50,1278,338,237,3922,781,3173,1853,7876,4703,1616
50686,50,188,5,23,621,24,458,216,1103,645,193
50689,50,5727,617,171,16727,1634,3283,6515,21644,18361,6344
50711,50,2468,1287,1958,7161,2504,6580,5713,16245,9665,3755
52001,52,55828,11442,869,270961,50864,27014,68139,348839,321825,67270
52019,52,557,60,26,2294,385,5500,643,8179,2679,617
52022,52,295,152,18,1510,1091,4251,465,6852,2601,447
52036,52,543,55,33,1989,161,5330,631,7480,2150,598
52051,52,319,105,23,1146,510,5961,447,7617,1656,424
52079,52,2296,366,1453,10837,1260,11090,4115,23187,12097,2662
52083,52,679,78,27,3182,344,2433,784,5959,3526,757
52110,52,729,711,163,5813,2808,11296,1603,19917,8621,1440
52203,52,300,151,22,965,804,5974,473,7743,1769,451
52207,52,361,333,40,1879,1852,6358,734,10089,3731,694
52210,52,347,100,24,1258,369,4775,471,6402,1627,447
52215,52,855,229,69,3026,992,10685,1153,14703,4018,1084
52224,52,523,0,48,2672,0,6268,571,8940,2672,523
52227,52,1732,758,451,6582,3802,20165,2941,30549,10384,2490
52233,52,447,511,214,1471,1389,2224,1172,5084,2860,958
52240,52,1181,1348,112,4251,1966,6129,2641,12346,6217,2529
52250,52,1615,261,1002,6973,1005,12845,2878,20823,7978,1876
52254,52,311,90,32,1172,340,4639,433,6151,1512,401
52256,52,480,527,221,1515,1472,3510,1228,6497,2987,1007
52258,52,348,402,144,1453,3037,8526,894,13016,4490,750
52260,52,1198,0,94,4787,0,7599,1292,12386,4787,1198
52287,52,786,70,62,2779,303,3087,918,6169,3082,856
52317,52,830,440,200,3031,1865,13866,1470,18762,4896,1270
52320,52,1255,51,59,4056,135,6573,1365,10764,4191,1306
52323,52,813,130,22,2875,451,2958,965,6284,3326,943
52352,52,478,122,40,1999,261,4846,640,7106,2260,600
52354,52,225,407,48,874,1729,3738,680,6341,2603,632
52356,52,14542,1287,367,69890,7269,26997,16196,104156,77159,15829
52378,52,1396,379,77,7548,2183,6929,1852,16660,9731,1775
52381,52,280,388,35,1816,1549,5676,703,9041,3365,668
52385,52,635,179,107,2817,490,1987,921,5294,3307,814
52390,52,799,138,328,2881,776,2190,1265,5847,3657,937
52399,52,2945,380,116,11367,1336,15776,3441,28479,12703,3325
52405,52,770,371,239,2639,1106,4425,1380,8170,3745,1141
52411,52,358,325,44,1893,1592,5454,727,8939,3485,683
52418,52,1228,0,145,4043,0,4635,1373,8678,4043,1228
52427,52,762,263,548,6609,1909,9657,1573,18175,8518,1025
52435,52,244,634,874,1139,2060,4750,1752,7949,3199,878
52473,52,1045,681,265,4641,2624,2513,1991,9778,7265,1726
52480,52,773,0,27,2604,0,1392,800,3996,2604,773
52490,52,2805,514,547,10056,2051,9210,3866,21317,12107,3319
52506,52,558,153,66,1895,421,4169,777,6485,2316,711
52520,52,1208,161,190,4733,481,2185,1559,7399,5214,1369
52540,52,681,811,180,2516,2675,2945,1672,8136,5191,1492
52560,52,544,57,193,2035,192,7920,794,10147,2227,601
52565,52,434,43,35,1269,114,3232,512,4615,1383,477
52573,52,905,507,108,3403,1607,3388,1520,8398,5010,1412
52585,52,1491,326,38,5487,1129,9779,1855,16395,6616,1817
52612,52,679,756,800,2084,1782,4517,2235,8383,3866,1435
52621,52,303,430,764,2288,1459,6604,1497,10351,3747,733
52678,52,2201,446,541,7703,1478,13236,3188,22417,9181,2647
52683,52,2527,1193,68,9231,3529,6057,3788,18817,12760,3720
52685,52,646,13,25,2496,76,6300,684,8872,2572,659
52687,52,544,373,127,1977,1271,13365,1044,16613,3248,917
52693,52,1041,346,48,3656,1104,8139,1435,12899,4760,1387
52694,52,226,11,24,784,60,5728,261,6572,844,237
52696,52,477,334,761,3141,1111,4505,1572,8757,4252,811
52699,52,356,66,414,1515,280,7393,836,9188,1795,422
52720,52,440,244,27,1425,1078,4383,711,6886,2503,684
52786,52,1032,1747,95,3656,4721,6976,2874,15353,8377,2779
52788,52,713,136,54,2745,330,7238,903,10313,3075,849
52835,52,18733,7959,2457,73025,27521,23069,29149,123615,100546,26692
52838,52,4525,929,137,16871,3379,17963,5591,38213,20250,5454
52885,52,1060,160,39,3316,600,6662,1259,10578,3916,1220
54001,54,160666,4443,1401,602268,14736,7395,166510,624399,617004,165109
54003,54,3629,21,371,15391,72,14618,4021,30081,15463,3650
54051,54,575,105,96,2049,304,5744,776,8097,2353,680
54099,54,967,567,38,2560,2206,2094,1572,6860,4766,1534
54109,54,125,172,91,416,578,3704,388,4698,994,297
54125,54,212,0,37,868,0,1855,249,2723,868,212
54128,54,442,334,106,1536,1251,5840,882,8627,2787,776
54172,54,3699,343,32,10787,685,4476,4074,15948,11472,4042
54174,54,832,50,83,4302,406,5350,965,10058,4708,882
54206,54,2145,316,385,7175,1160,9108,2846,17443,8335,2461
54223,54,430,79,113,1478,234,5926,622,7638,1712,509
54239,54,620,66,30,2165,309,1891,716,4365,2474,686
54245,54,690,828,255,2072,2609,6799,1773,11480,4681,1518
54250,54,1747,308,352,8223,1355,9357,2407,18935,9578,2055
54261,54,3327,582,752,16091,2437,7443,4661,25971,18528,3909
54313,54,553,71,69,1742,218,3948,693,5908,1960,624
54344,54,279,117,524,1198,463,7960,920,9621,1661,396
54347,54,211,0,28,1105,0,3576,239,4681,1105,211
54377,54,336,0,69,1592,0,3946,405,5538,1592,336
54385,54,426,672,173,1548,3796,5694,1271,11038,5344,1098
54398,54,246,156,110,710,602,5829,512,7141,1312,402
54405,54,20654,514,128,78520,1176,1386,21296,81082,79696,21168
54418,54,544,0,10,1787,0,1813,554,3600,1787,544
54480,54,194,62,34,729,303,2856,290,3888,1032,256
54498,54,23428,700,295,99149,2128,9073,24423,110350,101277,24128
54518,54,9204,0,64,40941,0,3830,9268,44771,40941,9204
54520,54,265,127,58,971,452,3506,450,4929,1423,392
54553,54,1539,8,16,7685,69,375,1563,8129,7754,1547
54599,54,660,16,27,2830,98,2448,703,5376,2928,676
54660,54,1203,220,137,3708,587,4421,1560,8716,4295,1423
54670,54,408,139,205,1750,708,7446,752,9904,2458,547
54673,54,739,1044,73,2248,3485,944,1856,6677,5733,1783
54680,54,462,0,53,1730,0,1347,515,3077,1730,462
54720,54,2459,231,411,9172,828,11098,3101,21098,10000,2690
54743,54,270,359,154,840,1302,3571,783,5713,2142,629
54800,54,669,31,120,2405,2080,8025,820,12510,4485,700
54810,54,3973,2268,1041,18935,11935,20017,7282,50887,30870,6241
54820,54,1290,278,582,4777,940,8309,2150,14026,5717,1568
54871,54,645,0,77,1877,0,2720,722,4597,1877,645
54874,54,24536,481,118,90954,1626,889,25135,93469,92580,25017
63001,63,63732,994,190,266091,2574,4377,64916,273042,268665,64726
63111,63,360,39,18,1178,172,1310,417,2660,1350,399
63130,63,13875,2593,124,53789,9741,5792,16592,69322,63530,16468
63190,63,5224,870,48,20459,2837,3784,6142,27080,23296,6094
63212,63,883,0,20,3293,0,2118,903,5411,3293,883
63272,63,1655,100,36,6292,364,4522,1791,11178,6656,1755
63302,63,989,0,36,3960,0,3070,1025,7030,3960,989
63401,63,7101,219,79,29378,775,2115,7399,32268,30153,7320
63470,63,7422,226,67,29576,1815,3683,7715,35074,31391,7648
63548,63,605,9,60,2870,88,1875,674,4833,2958,614
63594,63,5586,248,54,23867,938,4160,5888,28965,24805,5834
63690,63,980,171,50,3725,711,3043,1201,7479,4436,1151
66001,66,74284,11907,2350,334479,42994,28964,88541,406437,377473,86191
66045,66,1269,82,34,4850,258,5553,1385,10661,5108,1351
66075,66,379,85,47,1443,302,3228,511,4973,1745,464
66088,66,2801,269,67,10945,994,9276,3137,21215,11939,3070
66170,66,41424,929,382,183657,3192,7302,42735,194151,186849,42353
66318,66,843,467,56,3423,1752,6336,1366,11511,5175,1310
66383,66,704,21,50,2498,65,3582,775,6145,2563,725
66400,66,6351,32,22,25287,126,393,6405,25806,25413,6383
66440,66,2150,243,209,7999,674,6730,2602,15403,8673,2393
66456,66,1226,191,362,3611,666,4911,1779,9188,4277,1417
66572,66,820,371,462,2620,1050,7742,1653,11412,3670,1191
66594,66,1994,692,112,6743,2712,15697,2798,25152,9455,2686
66682,66,13500,560,398,60273,1730,8522,14458,70525,62003,14060
66687,66,1440,265,54,5596,1130,4921,1759,11647,6726,1705
68001,68,46474,515,326,513018,3187,6473,47315,522678,516205,46989
68013,68,95,0,15,291,0,1358,110,1649,291,95
68020,68,140,33,34,493,93,2719,207,3305,586,173
68051,68,442,54,54,2279,431,5133,550,7843,2710,496
68077,68,5482,686,51,22486,1782,4450,6219,28718,24268,6168
68079,68,1079,107,60,2814,290,4466,1246,7570,3104,1186
68081,68,42761,2987,934,173855,11484,12422,46682,197761,185339,45748
68092,68,490,394,97,1224,1673,2282,981,5179,2897,884
68101,68,388,136,147,1461,442,7528,671,9431,1903,524
68121,68,84,0,14,351,0,1252,98,1603,351,84
68132,68,183,38,15,862,126,793,236,1781,988,221
68147,68,819,0,26,3311,0,1965,845,5276,3311,819
68152,68,216,38,68,619,112,3398,322,4129,731,254
68160,68,119,0,50,425,0,1443,169,1868,425,119
68162,68,556,26,60,3228,100,3060,642,6388,3328,582
68167,68,2053,63,112,6831,149,3937,2228,10917,6980,2116
68169,68,294,0,38,683,0,2131,332,2814,683,294
68176,68,229,0,25,729,0,1635,254,2364,729,229
68179,68,183,31,18,568,90,3677,232,4335,658,214
68190,68,3397,1559,1027,11741,4665,8373,5983,24779,16406,4956
68207,68,792,0,38,2708,0,2508,830,5216,2708,792
68209,68,164,0,9,652,0,2241,173,2893,652,164
68211,68,941,12,15,2399,34,746,968,3179,2433,953
68217,68,251,97,123,672,281,3815,471,4768,953,348
68229,68,1209,0,113,4521,0,7064,1322,11585,4521,1209
68235,68,412,101,180,2420,810,14324,693,17554,3230,513
68245,68,164,69,16,532,193,914,249,1639,725,233
68250,68,234,169,125,671,427,2997,528,4095,1098,403
68255,68,1587,337,119,6782,841,5202,2043,12825,7623,1924
68264,68,129,0,54,514,0,1814,183,2328,514,129
68266,68,237,34,18,831,71,2470,289,3372,902,271
68271,68,516,33,69,1134,126,3336,618,4596,1260,549
68276,68,38153,595,144,263696,3888,6662,38892,274246,267584,38748
68296,68,57,0,18,755,0,1911,75,2666,755,57
68298,68,144,32,81,598,144,2758,257,3500,742,176
68307,68,24005,1521,540,131524,5685,11255,26066,148464,137209,25526
68318,68,569,13,83,1504,32,4201,665,5737,1536,582
68320,68,541,12,40,1490,47,2280,593,3817,1537,553
68322,68,180,0,21,555,0,1494,201,2049,555,180
68324,68,362,0,52,1010,0,2733,414,3743,1010,362
68327,68,773,0,16,2740,0,1643,789,4383,2740,773
68344,68,176,0,21,610,0,1510,197,2120,610,176
68368,68,232,0,20,647,0,2340,252,2987,647,232
68370,68,17,0,12,96,0,1067,29,1163,96,17
68377,68,396,91,123,1558,347,3591,610,5496,1905,487
68385,68,904,134,120,3056,883,5273,1158,9212,3939,1038
68397,68,251,101,29,697,252,3033,381,3982,949,352
68406,68,3604,218,236,19399,614,17057,4058,37070,20013,3822
68418,68,328,66,222,1629,451,10267,616,12347,2080,394
68425,68,86,7,24,267,43,1814,117,2124,310,93
68432,68,3821,24,14,16834,74,2653,3859,19561,16908,3845
68444,68,215,57,49,1219,168,3081,321,4468,1387,272
68464,68,1144,60,92,3920,154,6029,1296,10103,4074,1204
68468,68,212,6,43,620,34,3261,261,3915,654,218
68498,68,243,0,15,771,0,3766,258,4537,771,243
68500,68,1267,8,93,4468,24,5613,1368,10105,4492,1275
68502,68,499,35,80,1107,55,2764,614,3926,1162,534
68522,68,178,0,36,422,0,822,214,1244,422,178
68524,68,174,0,18,725,0,1702,192,2427,725,174
68533,68,330,0,61,1209,0,2930,391,4139,1209,330
68547,68,23537,2555,827,127370,9820,19391,26919,156581,137190,26092
68549,68,231,123,44,1014,332,3088,398,4434,1346,354
68572,68,1537,84,64,4987,164,7293,1685,12444,5151,1621
68573,68,767,790,377,2387,2257,2137,1934,6781,4644,1557
68575,68,5242,3354,336,16041,11499,4129,8932,31669,27540,8596
68615,68,1245,1438,420,6104,5272,13823,3103,25199,11376,2683
68655,68,7114,908,324,18577,3242,5867,8346,27686,21819,8022
68669,68,858,155,81,2842,433,4708,1094,7983,3275,1013
68673,68,26,132,9,242,416,2047,167,2705,658,158
68679,68,10747,0,56,47627,0,6320,10803,53947,47627,10747
68682,68,316,8,18,754,12,1395,342,2161,766,324
68684,68,249,80,17,848,274,3007,346,4129,1122,329
68686,68,196,0,23,629,0,1789,219,2418,629,196
68689,68,3192,1236,429,10918,3160,14625,4857,28703,14078,4428
68705,68,86,0,32,203,0,2035,118,2238,203,86
68720,68,176,230,81,718,688,1751,487,3157,1406,406
68745,68,619,82,231,1895,341,5515,932,7751,2236,701
68755,68,6517,16,61,23682,58,5196,6594,28936,23740,6533
68770,68,367,646,79,1783,1978,4969,1092,8730,3761,1013
68773,68,129,276,68,464,1154,4414,473,6032,1618,405
68780,68,282,60,57,902,144,2474,399,3520,1046,342
68820,68,181,93,61,499,1130,5050,335,6679,1629,274
68855,68,611,0,28,2319,0,3327,639,5646,2319,611
68861,68,2992,263,350,10461,1206,6494,3605,18161,11667,3255
68867,68,207,0,26,708,0,1054,233,1762,708,207
68872,68,1368,0,36,4432,0,2291,1404,6723,4432,1368
68895,68,2078,211,83,5891,352,2614,2372,8857,6243,2289
70001,70,55857,4117,306,246227,17305,6304,60280,269836,263532,59974
70110,70,2122,222,40,8303,839,861,2384,10003,9142,2344
70124,70,893,1357,130,3636,6479,3208,2380,13323,10115,2250
70204,70,565,572,63,3435,2455,1771,1200,7661,5890,1137
70215,70,12936,2886,171,50986,11954,2858,15993,65798,62940,15822
70221,70,2165,808,366,8112,4064,2668,3339,14844,12176,2973
70230,70,684,139,42,2852,600,969,865,4421,3452,823
70233,70,1136,1325,63,4314,4612,781,2524,9707,8926,2461
70235,70,2975,1139,111,11879,4504,3840,4225,20223,16383,4114
70265,70,1665,410,173,6767,1848,6998,2248,15613,8615,2075
70400,70,1182,309,92,5478,1497,4504,1583,11479,6975,1491
70418,70,2668,1861,194,10954,6716,4135,4723,21805,17670,4529
70429,70,2283,1548,377,9460,6660,16463,4208,32583,16120,3831
70473,70,2236,833,116,8930,2948,2746,3185,14624,11878,3069
70508,70,2943,2151,222,11406,7849,1909,5316,21164,19255,5094
70523,70,772,413,49,4422,3652,2585,1234,10659,8074,1185
70670,70,5531,1559,180,23313,6098,3764,7270,33175,29411,7090
70678,70,1629,3651,547,5884,13493,6091,5827,25468,19377,5280
70702,70,1376,983,40,6881,4789,1762,2399,13432,11670,2359
70708,70,7766,3279,387,31190,13636,7507,11432,52333,44826,11045
70713,70,4417,6130,381,18985,23726,5197,10928,47908,42711,10547
70717,70,3379,763,22,12181,3231,2588,4164,18000,15412,4142
70742,70,5679,1274,58,22480,5072,2624,7011,30176,27552,6953
70771,70,1749,1548,425,5967,6540,11434,3722,23941,12507,3297
70820,70,6745,834,153,25948,3762,2138,7732,31848,29710,7579
70823,70,1288,2203,145,6447,10520,3052,3636,20019,16967,3491
73001,73,100403,1979,1763,462225,7169,24009,104145,493403,469394,102382
73024,73,657,284,90,1693,659,1718,1031,4070,2352,941
73026,73,784,177,71,3090,735,2876,1032,6701,3825,961
73030,73,1483,171,119,5208,164,1137,1773,6509,5372,1654
73043,73,472,95,107,1277,304,6007,674,7588,1581,567
73055,73,2992,354,86,7973,884,2394,3432,11251,8857,3346
73067,73,1515,661,240,4706,1912,11482,2416,18100,6618,2176
73124,73,1985,259,73,9271,1123,6794,2317,17188,10394,2244
73148,73,2860,0,154,7515,0,2074,3014,9589,7515,2860
73152,73,558,78,34,1582,204,3705,670,5491,1786,636
73168,73,7995,258,551,27245,820,15031,8804,43096,28065,8253
73200,73,511,654,212,1470,2357,3620,1377,7447,3827,1165
73217,73,1291,734,581,3532,1825,12907,2606,18264,5357,2025
73226,73,751,497,121,2082,1523,4135,1369,7740,3605,1248
73236,73,659,90,103,3042,413,3805,852,7260,3455,749
73268,73,14249,1441,151,49154,6741,11168,15841,67063,55895,15690
73270,73,404,91,48,1584,490,4537,543,6611,2074,495
73275,73,12310,410,64,23937,993,2355,12784,27285,24930,12720
73283,73,2931,286,79,15295,1274,12194,3296,28763,16569,3217
73319,73,5132,437,302,16163,2279,11820,5871,30262,18442,5569
73347,73,668,427,33,1906,1167,3288,1128,6361,3073,1095
73349,73,7580,47,80,21964,129,521,7707,22614,22093,7627
73352,73,923,148,171,3307,592,6056,1242,9955,3899,1071
73408,73,4320,759,79,13336,1736,1876,5158,16948,15072,5079
73411,73,6763,515,152,21756,1340,9589,7430,32685,23096,7278
73443,73,8290,225,171,27071,658,6366,8686,34095,27729,8515
73449,73,7114,404,210,27661,1023,5012,7728,33696,28684,7518
73461,73,521,39,61,1555,82,1699,621,3336,1637,560
73483,73,2251,118,195,7788,906,5523,2564,14217,8694,2369
73504,73,1763,511,490,6828,2138,19449,2764,28415,8966,2274
73520,73,853,126,28,2923,403,5856,1007,9182,3326,979
73547,73,769,436,189,1901,1249,2285,1394,5435,3150,1205
73555,73,1924,719,426,6490,2519,12302,3069,21311,9009,2643
73563,73,1241,97,237,3725,211,3949,1575,7885,3936,1338
73585,73,4248,637,514,12579,2091,7729,5399,22399,14670,4885
73616,73,950,835,473,3643,2813,12589,2258,19045,6456,1785
73622,73,384,99,70,1811,319,2963,553,5093,2130,483
73624,73,3172,282,241,10041,720,9428,3695,20189,10761,3454
73671,73,2305,179,65,8320,1086,4126,2549,13532,9406,2484
73675,73,1406,276,89,4257,714,6375,1771,11346,4971,1682
73678,73,1270,802,217,3618,2639,5873,2289,12130,6257,2072
73686,73,590,144,49,1836,438,2743,783,5017,2274,734
73770,73,82,21,29,1487,362,1594,132,3443,1849,103
73854,73,717,0,126,2046,0,2455,843,4501,2046,717
73861,73,2483,163,89,8491,448,3138,2735,12077,8939,2646
73870,73,1120,0,84,3004,0,5504,1204,8508,3004,1120
73873,73,710,102,251,1876,217,2901,1063,4994,2093,812
76001,76,316292,8305,760,1769335,32443,8578,325357,1810356,1801778,324597
76020,76,2566,49,41,9540,123,2499,2656,12162,9663,2615
76036,76,4475,527,79,14398,1403,2308,5081,18109,15801,5002
76041,76,1975,508,105,9923,2058,3588,2588,15569,11981,2483
76054,76,679,99,105,2597,257,2072,883,4926,2854,778
76100,76,1390,1796,220,3755,4694,4202,3406,12651,8449,3186
76109,76,53775,6097,3293,213189,22438,18762,63165,254389,235627,59872
76111,76,25771,2951,238,99309,10175,4518,28960,114002,109484,28722
76113,76,3234,1686,188,11484,4990,5510,5108,21984,16474,4920
76122,76,5394,311,53,21478,1009,3570,5758,26057,22487,5705
76126,76,3038,71,328,10794,199,5007,3437,16000,10993,3109
76130,76,4874,13659,196,22117,56308,6171,18729,84596,78425,18533
76147,76,30119,132,105,114538,450,2374,30356,117362,114988,30251
76233,76,2768,4481,1587,9989,11229,18278,8836,39496,21218,7249
76243,76,576,447,88,2148,1327,3895,1111,7370,3475,1023
76246,76,735,161,46,2586,545,2984,942,6115,3131,896
76248,76,8604,3790,311,34578,14962,4349,12705,53889,49540,12394
76250,76,1575,194,116,5159,518,2351,1885,8028,5677,1769
76275,76,8611,2630,577,37781,10602,5488,11818,53871,48383,11241
76306,76,2333,1628,75,8512,6376,4053,4036,18941,14888,3961
76318,76,4358,1737,46,18529,8225,3315,6141,30069,26754,6095
76364,76,24131,3971,589,101216,13238,12514,28691,126968,114454,28102
76377,76,912,1524,155,2758,2926,7144,2591,12828,5684,2436
76400,76,6646,715,82,24420,2544,2400,7443,29364,26964,7361
76403,76,2623,851,52,8037,1993,1005,3526,11035,10030,3474
76497,76,2422,408,48,8067,1038,1857,2878,10962,9105,2830
76520,76,62773,14423,641,233682,55613,9684,77837,298979,289295,77196
76563,76,9148,567,159,38342,2371,2655,9874,43368,40713,9715
76606,76,2104,131,84,8621,390,3706,2319,12717,9011,2235
76616,76,1428,1261,67,6332,3719,3962,2756,14013,10051,2689
76622,76,6522,1351,95,23568,4189,3611,7968,31368,27757,7873
76670,76,1793,1312,196,6939,5882,2602,3301,15423,12821,3105
76736,76,7162,388,110,28044,1417,6804,7660,36265,29461,7550
76823,76,2545,712,82,8328,2032,1702,3339,12062,10360,3257
76828,76,1932,885,161,7832,3237,5207,2978,16276,11069,2817
76834,76,35540,6066,457,154742,21258,9564,42063,185564,176000,41606
76845,76,672,260,17,2195,767,1805,949,4767,2962,932
76863,76,1153,389,45,3271,1045,1916,1587,6232,4316,1542
76869,76,2181,211,80,7558,465,2718,2472,10741,8023,2392
76890,76,2347,810,142,8258,2963,4092,3299,15313,11221,3157
76892,76,19682,1592,532,84464,3766,6508,21806,94738,88230,21274
76895,76,7867,2089,95,29741,7762,1749,10051,39252,37503,9956
81001,81,18149,137,739,64834,1105,7917,19025,73856,65939,18286
81065,81,3567,3643,1245,13057,13427,17519,8455,44003,26484,7210
81220,81,857,0,157,2662,0,972,1014,3634,2662,857
81300,81,2968,572,576,9175,1660,6079,4116,16914,10835,3540
81591,81,960,10,192,2910,38,1142,1162,4090,2948,970
81736,81,12843,681,230,39545,2682,8589,13754,50816,42227,13524
81794,81,6916,756,1249,25329,2795,10606,8921,38730,28124,7672
85001,85,34897,2121,756,132176,6809,15086,37774,154071,138985,37018
85010,85,5092,708,532,24362,2380,6537,6332,33279,26742,5800
85015,85,479,0,101,1212,0,744,580,1956,1212,479
85125,85,1701,201,727,4928,565,5164,2629,10657,5493,1902
85136,85,167,0,18,550,0,622,185,1172,550,167
85139,85,2952,198,226,9639,423,2729,3376,12791,10062,3150
85162,85,3469,420,241,10873,1106,2805,4130,14784,11979,3889
85225,85,618,122,366,1776,474,6120,1106,8370,2250,740
85230,85,1785,103,226,5132,224,1154,2114,6510,5356,1888
85250,85,6946,420,855,23839,1381,8623,8221,33843,25220,7366
85263,85,1897,11,202,6573,24,4067,2110,10664,6597,1908
85279,85,92,47,49,262,122,841,188,1225,384,139
85300,85,576,194,75,1602,440,958,845,3000,2042,770
85315,85,368,0,42,852,0,566,410,1418,852,368
85325,85,834,60,281,2758,223,4436,1175,7417,2981,894
85400,85,481,61,135,1492,196,4369,677,6057,1688,542
85410,85,3727,227,376,14062,1261,5891,4330,21214,15323,3954
85430,85,1578,198,266,6707,536,4279,2042,11522,7243,1776
85440,85,6449,546,546,24781,1388,5470,7541,31639,26169,6995
86001,86,9144,690,685,34887,2834,9335,10519,47056,37721,9834
86219,86,977,289,32,3268,1175,733,1298,5176,4443,1266
86320,86,6237,785,461,17711,2648,12058,7483,32417,20359,7022
86568,86,11021,779,1796,34762,2680,18291,13596,55733,37442,11800
86569,86,1304,413,463,4569,1230,5232,2180,11031,5799,1717
86571,86,1307,778,1828,4330,3070,9150,3913,16550,7400,2085
86573,86,2768,248,1471,9827,782,7611,4487,18220,10609,3016
86749,86,2570,134,130,9865,577,3598,2834,14040,10442,2704
86755,86,1158,87,162,3302,374,1875,1407,5551,3676,1245
86757,86,1266,692,149,4530,2302,7004,2107,13836,6832,1958
86760,86,915,55,98,3411,192,2853,1068,6456,3603,970
86865,86,3798,1163,378,13421,3684,9979,5339,27084,17105,4961
86885,86,3591,568,783,12779,1820,6751,4942,21350,14599,4159
88001,88,7007,3277,148,29754,12281,1034,10432,43069,42035,10284
88564,88,647,780,30,2074,2295,143,1457,4512,4369,1427
91001,91,6311,1435,263,30660,8673,1551,8009,40884,39333,7746
91263,91,0,89,136,0,989,630,225,1619,989,89
91405,91,0,164,268,0,579,1115,432,1694,579,164
91407,91,0,216,358,0,612,2246,574,2858,612,216
91430,91,0,0,25,0,0,112,25,112,0,0
91460,91,0,4,106,0,8,582,110,590,8,4
91530,91,0,66,39,0,294,387,105,681,294,66
91536,91,0,58,73,0,383,379,131,762,383,58
91540,91,412,434,281,2356,3338,1750,1127,7444,5694,846
91669,91,0,39,140,0,236,958,179,1194,236,39
91798,91,0,104,267,0,276,2472,371,2748,276,104
94001,94,4187,398,605,17852,2130,3107,5190,23089,19982,4585
94343,94,0,111,573,0,852,3516,684,4368,852,111
94663,94,0,0,122,0,0,728,122,728,0,0
94883,94,0,31,113,0,109,907,144,1016,109,31
94884,94,0,4,73,0,6,327,77,333,6,4
94885,94,0,14,21,0,66,91,35,157,66,14
94886,94,0,92,46,0,368,236,138,604,368,92
94887,94,0,19,47,0,130,301,66,431,130,19
94888,94,0,25,38,0,112,172,63,284,112,25
95001,95,10621,847,2105,33084,2405,8729,13573,44218,35489,11468
95015,95,1322,15,338,3953,43,3774,1675,7770,3996,1337
95025,95,1080,485,1197,3017,1271,5709,2762,9997,4288,1565
95200,95,515,266,627,1378,554,2014,1408,3946,1932,781
97001,97,1877,136,1110,7553,805,11970,3123,20328,8358,2013
97161,97,174,0,140,805,0,1223,314,2028,805,174
97511,97,0,37,193,0,136,1146,230,1282,136,37
97666,97,109,0,131,500,0,883,240,1383,500,109
97777,97,0,20,78,0,68,352,98,420,68,20
97889,97,0,7,78,0,12,377,85,389,12,7
99001,99,3856,400,333,12792,921,2329,4589,16042,13713,4256
99524,99,1721,148,472,5148,420,3253,2341,8821,5568,1869
99624,99,647,61,290,2282,82,1226,998,3590,2364,708
99773,99,1005,117,2184,2646,678,19551,3306,22875,3324,1122
